1111111111111111111111111111111111
1000000000000000000000000000000001
10000E0000000000000000000000000001
1000000000000000C00000000000000001
10000000000000000000000000P0000001
10000000000C0000000C00000000000001
1000000000000000000000000000000001
1111111111111111111111111111111111
